10
1 1 1 1 1 1 1 1 1 1
1 1 1 1 1 1 1 1 1 1
5 5 5 4 3 2 1 1 1 1
6 6 6 5 2 2 2 2 1 1
9 9 9 9 6 6 6 2 1 1
6 6 1 1 1 1 7 3 1 1
1 1 1 9 5 3 7 3 1 1
1 1 1 9 5 2 1 1 1 1
1 1 1 9 6 1 1 1 1 1
1 1 1 9 7 1 1 1 1 1